PPPPPPPPPPPPPPPP
EJCCPPPPCCCPCCCP
PPPCCCPPCPCPCPCP
PLPCPCPPCPCPCPCP
PCPCPCCCOPCCCPOP
PCPCPPPPPPPPPPPP
PCPCCCCCGCCCCCCP
PCPCPPPPPPPPPPCP
POCCPOCCCCCCCPCP
PPPPPPPPPPPPCCGP
POCCCCCCCCCCCPCS
PPPPPPPPPPPPPPPP
