PPPPPPPPPPPPPPPP
EJ..PPPP...P...P
PPP...PP.P.P.P.P
PLP.P.PP.P.P.P.P
P.P.P...OP...POP
P.P.PPPPPPPPPPPP
P.P.....G......P
P.P.PPPPPPPPPP.P
PO..PO.......P.P
PPPPPPPPPPPP..GP
PO...........P.S
PPPPPPPPPPPPPPPP
