PPPPPPPPPPPPPPPP
J...PPPP...P...P
PPP...PP.P.P.P.P
P.P.P.PP.P.P.P.P
P.P.P....P...P.P
P.P.PPPPPPPPPPPP
P.P............P
P.P.PPPPPPPPPP.P
P...P........P.P
PPPPPPPPPPPP...P
P............P..
PPPPPPPPPPPPPPPP
